[console_scripts]
pmg = pkglts.manage_script:main

[pkglts]
appveyor = pkglts.option.appveyor.option:OptionAppveyor
base = pkglts.option.base.option:OptionBase
conda = pkglts.option.conda.option:OptionConda
coverage = pkglts.option.coverage.option:OptionCoverage
coveralls = pkglts.option.coveralls.option:OptionCoveralls
data = pkglts.option.data.option:OptionData
doc = pkglts.option.doc.option:OptionDoc
flake8 = pkglts.option.flake8.option:OptionFlake8
git = pkglts.option.git.option:OptionGit
github = pkglts.option.github.option:OptionGithub
gitlab = pkglts.option.gitlab.option:OptionGitlab
landscape = pkglts.option.landscape.option:OptionLandscape
lgtm = pkglts.option.lgtm.option:OptionLgtm
license = pkglts.option.license.option:OptionLicense
notebook = pkglts.option.notebook.option:OptionNotebook
plugin_project = pkglts.option.plugin_project.option:OptionPluginProject
pypi = pkglts.option.pypi.option:OptionPypi
pysetup = pkglts.option.pysetup.option:OptionPysetup
readthedocs = pkglts.option.readthedocs.option:OptionReadthedocs
reqs = pkglts.option.reqs.option:OptionReqs
requires = pkglts.option.requires.option:OptionRequires
sphinx = pkglts.option.sphinx.option:OptionSphinx
src = pkglts.option.src.option:OptionSrc
test = pkglts.option.test.option:OptionTest
tox = pkglts.option.tox.option:OptionTox
travis = pkglts.option.travis.option:OptionTravis
version = pkglts.option.version.option:OptionVersion

