[cliff.formatter.completion]
fish = slapos.cli.complete:CompleteFish

[console_scripts]
slapos = slapos.cli.entry:main
slapos-watchdog = slapos.grid.watchdog:main

[slapos.cli]
cache lookup = slapos.cli.cache:CacheLookupCommand
cache source = slapos.cli.cache_source:CacheLookupCommand
complete = slapos.cli.complete:CompleteCommand
computer info = slapos.cli.computer_info:InfoCommand
computer list = slapos.cli.computer_list:ListCommand
computer token = slapos.cli.computer_token:TokenCommand
configure client = slapos.cli.configure_client:ConfigureClientCommand
configure local = slapos.cli.configure_local:ConfigureLocalCommand
console = slapos.cli.console:ConsoleCommand
node bang = slapos.cli.bang:BangCommand
node boot = slapos.cli.boot:BootCommand
node collect = slapos.cli.collect:CollectCommand
node format = slapos.cli.format:FormatCommand
node instance = slapos.cli.slapgrid:InstanceCommand
node promise = slapos.cli.slapgrid:PromiseCommand
node prune = slapos.cli.prune:PruneCommand
node register = slapos.cli.register:RegisterCommand
node report = slapos.cli.slapgrid:ReportCommand
node restart = slapos.cli.supervisorctl:SupervisorctlRestartCommand
node software = slapos.cli.slapgrid:SoftwareCommand
node start = slapos.cli.supervisorctl:SupervisorctlStartCommand
node status = slapos.cli.supervisorctl:SupervisorctlStatusCommand
node stop = slapos.cli.supervisorctl:SupervisorctlStopCommand
node supervisorctl = slapos.cli.supervisorctl:SupervisorctlCommand
node supervisord = slapos.cli.supervisord:SupervisordCommand
node tail = slapos.cli.supervisorctl:SupervisorctlTailCommand
proxy show = slapos.cli.proxy_show:ProxyShowCommand
proxy start = slapos.cli.proxy_start:ProxyStartCommand
remove = slapos.cli.remove:RemoveCommand
request = slapos.cli.request:RequestCommand
service info = slapos.cli.info:InfoCommand
service list = slapos.cli.list:ListCommand
supply = slapos.cli.supply:SupplyCommand

